 # # ###   B
 # #     ## 
   # #   ## 
# ## # # ## 
#    # #    
### ## #####
A     #     